aa- ba- ba- ba- ba- ba- ba- ba- ba- ba- ba- ba- ba- ba- ba- ba- ba- ba- ba- ba- ba- ba- ba- ba- ba- ba- ba- ba- ba- ba- ba- ba- ba- ba- ba-
ab- bb- bb- bb- bb- bb- bb- bb- bb- bb- bb- bb- bb- bb- bb- bb- bb- bb- bb- bb- bb- bb- bb- bb- bb- bb- bb- bb- bb- bb- bb- bb- bb- bb- bb-
ab- bb- bb- bb- bb- bb- bb- bb- bb- bb- bb- bb- bb- bb- bb- bb- bb- bb- bb- bb- bb- bb- bb- bb- bb- bb- bb- bb- bb- bb- bb- bb- bb- bb- bb-
ab- bb- bb- bb- bb- bb- bb- bb- bb- bb- bb- bb- bb- bb- bb- bb- bb- bb- bb- bb- bb- bb- bb- bb- bb- bb- bb- bb- bb- bb- bb- bb- bb- bb- bb-
ab- bb- bb- bb- bb- bb- bb- bb- cb- dhX dhX ab- bb- bb- bb- bb- bb- bb- bb- bb- bb- bb- bb- bb- bb- bb- bb- bb- bb- bb- bb- bb- bb- bb- bb-
ab- bb- bb- bb- bb- bb- bb- bb- cb- dhX dhX ab- ah- bh- ch- ed- bb- bb- bb- bb- bb- bb- bb- bb- bb- bb- bb- bb- bb- bb- bb- bb- bb- bb- bb-
ab- bb- bb- bb- bb- bb- bb- bb- cb- dhX dhX ab- bb- bb- bb- ee- bb- bb- bb- bb- bb- bb- bb- bb- bb- bb- bb- bb- bb- bb- bb- bb- bb- bb- bb-
ab- bb- bb- bb- bb- bb- bb- bb- bb- bb- bb- bb- bb- bb- bb- ee- bb- bb- bb- bb- bb- bb- bb- bb- bb- bb- bb- bb- bb- bb- bb- bb- bb- bb- bb-
ab- bb- bb- bb- bb- bb- bb- bb- bb- bb- bb- bb- bb- bb- bb- ef- bb- fd- bb- bb- bb- bb- bb- bb- bb- bb- bb- bb- bb- bb- bb- bb- bb- bb- bb-
ab- bb- bb- bb- bb- bb- bb- bb- bb- bb- bb- bb- bb- bb- bb- bb- bb- bb- bb- bb- bb- bb- bb- bb- bb- bb- bb- bb- bb- bb- bb- bb- bb- bb- bb-
ab- bb- bb- bb- bb- bb- bb- bb- bb- bb- bb- bb- bb- bb- bb- bb- bb- bb- bb- bb- bb- bb- bb- bb- bb- bb- bb- bb- bb- bb- bb- bb- bb- bb- bb-
ab- bb- bb- bb- bb- bb- bb- bb- bb- bb- bb- bb- bb- bb- bb- bb- bb- bb- bb- bb- bb- bb- bb- bb- bb- bb- bb- bb- bb- bb- bb- bb- bb- bb- bb-
ab- bb- bb- bb- bb- bb- bb- bb- bb- bb- bb- bb- bb- bb- bb- bb- bb- bb- bb- bb- bb- bb- bb- bb- bb- bb- bb- bb- bb- bb- bb- bb- bb- bb- bb-
ab- bb- bb- bb- bb- bb- bb- bb- bb- bb- bb- bb- bb- bb- bb- bb- bb- bb- bb- bb- bb- bb- bb- bb- bb- bb- bb- bb- bb- bb- bb- bb- bb- bb- bb-
ab- bb- bb- bb- bb- bb- bb- bb- bb- bb- bb- bb- bb- bb- bb- bb- bb- bb- bb- bb- bb- bb- bb- bb- bb- bb- bb- bb- bb- bb- bb- bb- bb- bb- bb-
ac- bc- bc- bc- bc- bc- bc- bc- bc- bc- bc- bc- bc- bc- bc- bc- bc- bc- bc- bc- bc- bc- bc- bc- bc- bc- bc- bc- bc- bc- bc- bc- bc- bc- bc- 