gg- gg- gg- gg- gg- gg- gg- gg- gg- gg- gg- gg- gg- gg- gg- gg- gg- gg- gg- gg- gg- gg- gg- gg- gg- gg- gg- gg- gg- gg- gg- gg- gg- gg- gg- gg-
gg- jaX kaX kaX kaX kaX kaX kaX kaX kaX kaX kaX kaX kaX kaX kaX kaX kaX kaX kaX kaX kaX kaX kaX kaX kaX kaX kaX kaX kaX kaX kaX kaX kaX kaX kaX
gg- jbX gg- gg- gg- gg- gg- gg- gg- gg- gg- gg- gg- gg- gg- gg- gg- gg- gg- gg- gg- gg- gg- gg- gg- gg- gg- gg- gg- gg- gg- gg- gg- jbX gg- jbX
gg- jbX gg- gg- gg- gg- gg- gg- gg- gg- gg- gg- gg- gg- gg- gg- gg- gg- gg- gg- gg- gg- gg- gg- gg- gg- gg- gg- gg- gg- gg- gg- gg- gg- jbX- jbX
gg- jbX gg- gg- gg- gg- gg- gg- geX heX ieX gg- gg- gg- gg- gg- gg- gg- gg- gg- gg- gg- gg- gg- gg- gg- gg- gg- gg- gg- gg- gg- gg- gg- gg- gg-
gg- jbX gg- gg- gg- gg- gg- gg- gg- gg- gg- gg- gg- gg- gg- gg- gg- gg- gg- gg- gg- gg- gg- gg- gg- gg- gg- gg- gg- gg- gg- gg- gg- gg- gg- gg-
gg- jbX gg- gg- gg- gg- fcX gg- gg- gg- gg- gg- gg- gg- gg- gg- gg- gg- gg- gg- gg- gg- gg- gg- gg- gg- gg- gg- gg- gg- gg- gg- gg- gg- gg- gg-
gg- jbX gg- gg- gg- gg- gg- gg- gg- gg- gg- gg- gg- gg- gg- gg- gg- gg- gg- gg- gg- geX heX ieX gg- gg- gg- gg- gg- gg- gg- gg- gg- gg- gg- gg-
gg- jbX gg- gg- gg- gg- gg- gg- gg- gg- gg- gg- gg- gg- gg- gg- gg- gg- gg- gg- gg- gg- gg- gg- gg- gg- gg- gg- gg- gg- gg- gg- gg- gg- gg- gg-
gg- jbX gg- gg- gg- gg- gg- gg- gg- gg- gg- gg- gg- gg- gg- gg- gg- gg- gg- gg- gg- gg- gg- gg- gg- gg- gg- gg- gg- gg- gg- gg- gg- gg- gg- gg-
gg- jbX gg- gg- gg- gg- gg- gg- gg- gg- gg- gg- gg- gg- gg- gg- gg- gg- gg- gg- gg- gg- gg- gg- gg- gg- gg- gg- gg- gg- gg- gg- gg- gg- gg- gg-
gg- jbX gg- gg- gg- gg- gg- gg- gg- gg- gg- gg- gg- gg- gg- gg- gg- gg- gg- gg- gg- gg- gg- gg- gg- gg- gg- gg- gg- gg- gg- gg- gg- gg- gg- gg-
gg- jbX gg- gg- gg- gg- gg- gg- gg- gg- gg- gg- gg- gg- gg- gg- gg- gg- gg- gg- gg- gg- gg- gg- gg- gg- gg- gg- gg- gg- gg- gg- gg- gg- gg- gg-
gg- jbX gg- gg- gg- gg- gg- gg- gg- gg- gg- gg- gg- gg- gg- gg- gg- gg- gg- gg- gg- gg- gg- gg- gg- gg- gg- gg- gg- gg- gg- gg- gg- gg- gg- gg-
gg- jcX kcX kcX kcX kcX kcX kcX kcX kcX kcX kcX kcX kcX kcX kcX kcX kcX kcX kcX kcX kcX kcX kcX kcX kcX kcX kcX kcX kcX kcX kcX kcX kcX kcX kcX
gg- gg- gg- gg- gg- gg- gg- gg- gg- gg- gg- gg- gg- gg- gg- gg- gg- gg- gg- gg- gg- gg- gg- gg- gg- gg- gg- gg- gg- gg- gg- gg- gg- gg- gg- gg-